*******************---***********************
*                                           *
*    Y   D   K   M   C   P                  *
*                                           *
*                                           *
*                                           *
*                                           *
*                                           *
*                                           *
*                                           *
*                                           *
*                                           *
*                                           *
*                                           *
*                                           *
*                                           *
*                                           *
*                                           *
*                                           *
*                                           *
*                                           *
*                                           *
*********************************************